################
#...........#..#
#..........#...#
#..........#...#
#..########....#
#..,,,.........#
#..,,,.........#
#........,,,...#
#........,,,...#
#....#######...#
#...#..........#
#...#..........#
#..#...@.......#
################